1 1
10 10
##########
#  #  #  #
#        #
# ##     #
#     ####
#        #
###      #
## # #   #
#  E     #
##########